Bezirk,Bezirkname,Prognoseraum,Bezirksregion,Planungsraum,Planungsraumname,total,0_6,6_15,15_18,18_27,27_45,45_55,55_65,65 _mehr,weiblich,männlich ,weiblich%,männlich%,Ausländer,6_18,0_18
1,Mitte,1,11,1,Stülerstraße,3420,162,124,30,510,1105,335,393,761,1634,1786,0.4778,0.5222,1427,154,316
1,Mitte,1,11,2,Großer Tiergarten,186,0,9,3,20,62,27,31,34,73,113,0.3925,0.6075,63,12,12
1,Mitte,1,11,3,Lützowstraße,5083,255,306,111,600,1492,650,748,921,2356,2727,0.4635,0.5365,1774,417,672
1,Mitte,1,11,4,Körnerstraße,4641,266,398,143,787,1619,609,453,366,2073,2568,0.4467,0.5533,1811,541,807
1,Mitte,1,11,5,Nördlicher Landwehrkanal,1531,106,72,19,134,545,235,191,229,710,821,0.4637,0.5363,749,91,197
1,Mitte,1,12,1,Wilhelmstraße,2403,123,141,66,282,696,310,354,431,1145,1258,0.4765,0.5235,1004,207,330
1,Mitte,1,12,2,Unter den Linden Nord,648,43,36,6,67,212,104,85,95,300,348,0.463,0.537,237,42,85
1,Mitte,1,12,3,Unter den Linden Süd,1133,72,55,18,91,368,199,149,181,518,615,0.4572,0.5428,412,73,145
1,Mitte,1,12,4,Leipziger Straße,8376,491,415,102,709,2954,1084,950,1671,4086,4290,0.4878,0.5122,2838,517,1008
1,Mitte,1,13,1,Charitéviertel,6899,444,410,85,656,2994,1022,626,662,3328,3571,0.4824,0.5176,2083,495,939
1,Mitte,1,13,2,Oranienburger Straße,12597,687,992,315,1056,4911,2329,1300,1007,6094,6503,0.4838,0.5162,3462,1307,1994
1,Mitte,1,13,3,Alexanderplatzviertel,10054,472,503,107,1237,3986,1219,1012,1518,4733,5321,0.4708,0.5292,3537,610,1082
1,Mitte,1,13,4,Karl-Marx-Allee,8732,498,549,153,807,2348,892,988,2497,4626,4106,0.5298,0.4702,2290,702,1200
1,Mitte,1,13,5,Heine-Viertel West,8529,453,410,119,744,2933,1048,916,1906,4182,4347,0.4903,0.5097,2325,529,982
1,Mitte,1,13,6,Heine-Viertel Ost,10721,625,534,117,1489,3789,1363,1193,1611,5307,5414,0.495,0.505,3219,651,1276
1,Mitte,1,14,1,Invalidenstraße,18141,1299,1447,320,1674,8061,2906,1436,998,8900,9241,0.4906,0.5094,5779,1767,3066
1,Mitte,1,14,2,Arkonaplatz,13699,1021,1129,213,1059,6187,2309,936,845,6791,6908,0.4957,0.5043,3779,1342,2363
1,Mitte,2,21,1,Huttenkiez,3626,210,220,55,557,1464,440,392,288,1615,2011,0.4454,0.5546,1391,275,485
1,Mitte,2,21,2,Beusselkiez,6795,362,406,143,1228,2539,825,660,632,3131,3664,0.4608,0.5392,2917,549,911
1,Mitte,2,21,3,Westhafen,261,19,40,15,28,89,21,29,20,127,134,0.4866,0.5134,151,55,74
1,Mitte,2,21,4,Emdener Straße,18855,1018,1160,343,2681,7013,2298,2149,2193,8919,9936,0.473,0.527,6202,1503,2521
1,Mitte,2,21,5,Zwinglistraße,5359,317,373,122,822,1953,663,539,570,2501,2858,0.4667,0.5333,1996,495,812
1,Mitte,2,21,6,Elberfelder Straße,11404,573,695,216,1265,3402,1576,1684,1993,5794,5610,0.5081,0.4919,2338,911,1484
1,Mitte,2,22,1,Stephankiez,10976,640,724,180,1678,4419,1302,1058,975,5178,5798,0.4718,0.5282,3447,904,1544
1,Mitte,2,22,2,Heidestraße,2777,220,195,57,414,1164,306,199,222,1306,1471,0.4703,0.5297,1009,252,472
1,Mitte,2,22,3,Lübecker Straße,7065,475,654,177,970,2219,847,700,1023,3464,3601,0.4903,0.5097,2386,831,1306
1,Mitte,2,22,4,Thomasiusstraße,6085,329,349,98,679,2064,839,737,990,2925,3160,0.4807,0.5193,1628,447,776
1,Mitte,2,22,5,Zillesiedlung,3333,275,352,110,395,867,410,397,527,1632,1701,0.4896,0.5104,1109,462,737
1,Mitte,2,22,6,Lüneburger Straße,2976,127,209,60,309,966,449,374,482,1423,1553,0.4782,0.5218,646,269,396
1,Mitte,2,22,7,Hansaviertel,5786,202,239,85,1088,1565,694,659,1254,2805,2981,0.4848,0.5152,1986,324,526
1,Mitte,3,31,1,Soldiner Straße,27024,1957,2599,752,3950,9259,3261,2547,2699,12796,14228,0.4735,0.5265,11340,3351,5308
1,Mitte,3,31,2,Gesundbrunnen,11989,806,1022,310,1903,4107,1545,1070,1226,5736,6253,0.4784,0.5216,4665,1332,2138
1,Mitte,3,32,1,Brunnenstraße,14243,1151,1662,466,1703,4472,1688,1410,1691,7115,7128,0.4995,0.5005,4491,2128,3279
1,Mitte,3,32,2,Humboldthain Süd,10346,697,914,273,1285,3029,1201,1146,1801,5222,5124,0.5047,0.4953,3007,1187,1884
1,Mitte,3,32,3,Humboldthain Nordwest,14710,978,1288,447,2345,5119,1747,1305,1481,6841,7869,0.4651,0.5349,5930,1735,2713
1,Mitte,4,41,1,Rehberge,20950,1199,1353,393,2806,6941,2629,2507,3122,10100,10850,0.4821,0.5179,6596,1746,2945
1,Mitte,4,41,2,Schillerpark,16544,1005,1007,308,1732,4825,1946,2034,3687,8532,8012,0.5157,0.4843,4037,1315,2320
1,Mitte,4,41,3,Westliche Müllerstraße,8766,461,496,173,1408,3386,1111,958,773,4134,4632,0.4716,0.5284,3286,669,1130
1,Mitte,4,42,1,Reinickendorfer Straße,24209,1551,2151,659,3796,8484,2982,2174,2412,11356,12853,0.4691,0.5309,10653,2810,4361
1,Mitte,4,42,2,Sparrplatz,17071,953,1040,337,3014,7096,1886,1517,1228,7831,9240,0.4587,0.5413,7018,1377,2330
1,Mitte,4,42,3,Leopoldplatz,16229,898,1154,368,2156,5802,2004,1682,2165,7645,8584,0.4711,0.5289,6448,1522,2420
2,Friedrichshain–Kreuzberg,1,1,1,Askanischer Platz,6869,410,555,170,1163,2479,841,635,616,3116,3753,0.4536,0.5464,3031,725,1135
2,Friedrichshain–Kreuzberg,1,1,2,Mehringplatz,13661,919,1386,464,1773,4116,1806,1429,1768,6778,6883,0.4962,0.5038,4553,1850,2769
2,Friedrichshain–Kreuzberg,1,1,3,Moritzplatz,15142,1022,1542,491,1884,4376,2212,1605,2010,7468,7674,0.4932,0.5068,5360,2033,3055
2,Friedrichshain–Kreuzberg,1,1,4,Wassertorplatz,5052,274,534,187,597,1502,713,634,611,2516,2536,0.498,0.502,1625,721,995
2,Friedrichshain–Kreuzberg,2,2,1,Gleisdreieck/Entwicklungsgebiet,1834,181,167,27,119,691,190,187,272,916,918,0.4995,0.5005,388,194,375
2,Friedrichshain–Kreuzberg,2,2,2,Rathaus Yorckstraße,6116,405,482,149,727,2088,906,720,639,2947,3169,0.4819,0.5181,1766,631,1036
2,Friedrichshain–Kreuzberg,2,2,3,Viktoriapark,11020,712,777,173,1032,4168,1600,1399,1159,5380,5640,0.4882,0.5118,2732,950,1662
2,Friedrichshain–Kreuzberg,2,2,4,Urbanstraße,12659,742,808,243,1335,4854,1785,1597,1295,6124,6535,0.4838,0.5162,3449,1051,1793
2,Friedrichshain–Kreuzberg,2,2,5,Chamissokiez,14989,834,959,313,1604,5146,2347,2120,1666,7422,7567,0.4952,0.5048,3711,1272,2106
2,Friedrichshain–Kreuzberg,2,2,6,Graefekiez,19017,1264,1427,408,1818,7247,2738,2224,1891,9502,9515,0.4997,0.5003,5276,1835,3099
2,Friedrichshain–Kreuzberg,3,3,1,Oranienplatz,8984,442,676,247,1005,3104,1420,1057,1033,4302,4682,0.4789,0.5211,3422,923,1365
2,Friedrichshain–Kreuzberg,3,3,2,Lausitzer Platz,13117,733,981,317,1386,4716,1942,1643,1399,6319,6798,0.4817,0.5183,4249,1298,2031
2,Friedrichshain–Kreuzberg,3,4,1,Reichenberger Straße,15261,891,1017,324,1468,6235,2278,1688,1360,7338,7923,0.4808,0.5192,4870,1341,2232
2,Friedrichshain–Kreuzberg,3,4,2,Wrangelkiez,11141,632,706,202,1169,4660,1639,1193,940,5308,5833,0.4764,0.5236,3720,908,1540
2,Friedrichshain–Kreuzberg,4,5,1,Barnimkiez,5372,252,393,110,389,1178,644,684,1722,2838,2534,0.5283,0.4717,859,503,755
2,Friedrichshain–Kreuzberg,4,5,2,Friedenstraße,7493,465,426,94,752,2875,823,758,1300,3830,3663,0.5111,0.4889,1501,520,985
2,Friedrichshain–Kreuzberg,4,5,3,Richard-Sorge-Viertel,11244,835,656,142,943,5034,1402,909,1323,5594,5650,0.4975,0.5025,2034,798,1633
2,Friedrichshain–Kreuzberg,4,7,1,Andreasviertel,13324,787,774,215,1689,4566,1329,1311,2653,6720,6604,0.5044,0.4956,3767,989,1776
2,Friedrichshain–Kreuzberg,4,7,2,Weberwiese,11038,603,678,150,1152,4809,1465,984,1197,5342,5696,0.484,0.516,2253,828,1431
2,Friedrichshain–Kreuzberg,4,7,3,Wriezener Bahnhof/Entwicklungsgebiet,1135,91,109,34,173,574,73,52,29,501,634,0.4414,0.5586,691,143,234
2,Friedrichshain–Kreuzberg,5,6,1,Hausburgviertel,9191,608,487,90,961,4928,1015,593,509,4277,4914,0.4653,0.5347,2096,577,1185
2,Friedrichshain–Kreuzberg,5,6,2,Samariterviertel,21793,1567,1465,339,2029,11108,2779,1419,1087,10534,11259,0.4834,0.5166,4864,1804,3371
2,Friedrichshain–Kreuzberg,5,8,1,Traveplatz,20500,1377,1251,298,2293,10833,2337,1214,897,9724,10776,0.4743,0.5257,5393,1549,2926
2,Friedrichshain–Kreuzberg,5,8,2,Boxhagener Platz,21376,1438,1183,255,2268,11616,2695,1165,756,10131,11245,0.4739,0.5261,5238,1438,2876
2,Friedrichshain–Kreuzberg,5,8,3,Stralauer Kiez,7652,527,362,92,927,3945,759,521,519,3584,4068,0.4684,0.5316,1918,454,981
2,Friedrichshain–Kreuzberg,5,8,4,Stralauer Halbinsel,4782,507,445,105,254,1817,760,396,498,2324,2458,0.486,0.514,617,550,1057
3,Pankow,1,1,1,Bucher Forst,4275,378,342,70,311,1351,589,555,679,2029,2246,0.4746,0.5254,466,412,790
3,Pankow,1,1,2,Buch,12447,901,1051,316,1174,3136,1275,1415,3179,6418,6029,0.5156,0.4844,1990,1367,2268
3,Pankow,1,1,4,Lietzengraben,234,10,28,11,23,75,60,27,0,94,140,0.4017,0.5983,28,39,49
3,Pankow,2,2,3,Blankenfelde,2430,123,250,67,184,511,378,376,541,1145,1285,0.4712,0.5288,419,317,440
3,Pankow,2,2,9,Niederschönhausen,15034,996,1480,406,1257,3687,2572,2035,2601,7750,7284,0.5155,0.4845,1410,1886,2882
3,Pankow,2,2,10,Herthaplatz,11469,824,1149,305,775,2981,1998,1494,1943,5845,5624,0.5096,0.4904,1003,1454,2278
3,Pankow,2,3,7,Buchholz,18242,1253,1836,539,1147,4340,3067,2853,3207,9333,8909,0.5116,0.4884,995,2375,3628
3,Pankow,3,4,5,Karow Nord,11404,1017,1181,345,875,3248,1520,1346,1872,5919,5485,0.519,0.481,1166,1526,2543
3,Pankow,3,4,6,Alt-Karow,8211,414,671,217,554,1505,1417,1566,1867,4194,4017,0.5108,0.4892,323,888,1302
3,Pankow,3,7,11,Blankenburg,6862,351,631,179,386,1259,1191,1261,1604,3442,3420,0.5016,0.4984,199,810,1161
3,Pankow,3,7,15,Heinersdorf,7624,452,640,186,626,1688,1310,1179,1543,3687,3937,0.4836,0.5164,973,826,1278
3,Pankow,3,7,16,Märchenland,1123,36,73,37,42,166,186,220,363,572,551,0.5093,0.4907,9,110,146
3,Pankow,4,5,8,Rosenthal,4570,271,470,161,393,920,873,718,764,2270,2300,0.4967,0.5033,295,631,902
3,Pankow,4,5,12,Wilhelmsruh,10264,588,812,294,794,2385,1738,1396,2257,5351,4913,0.5213,0.4787,851,1106,1694
3,Pankow,4,5,13,Schönholz,3390,154,407,111,294,627,623,487,687,1741,1649,0.5136,0.4864,238,518,672
3,Pankow,4,6,14,Pankow Zentrum,36813,2701,3717,910,2667,10892,5641,3850,6435,19482,17331,0.5292,0.4708,3181,4627,7328
3,Pankow,4,8,18,Pankow Süd,35043,2330,2709,717,2599,11654,5152,3887,5995,18279,16764,0.5216,0.4784,3886,3426,5756
3,Pankow,5,9,19,Gustav-Adolf-Straße,5367,385,385,121,445,1457,807,678,1089,2744,2623,0.5113,0.4887,709,506,891
3,Pankow,5,9,20,Weißer See,7385,482,677,152,512,2203,1097,806,1456,3893,3492,0.5271,0.4729,632,829,1311
3,Pankow,5,9,23,Weißenseer Spitze,9717,751,731,162,847,4017,1348,941,920,4710,5007,0.4847,0.5153,1497,893,1644
3,Pankow,5,9,24,Behaimstraße,6163,500,582,125,583,2390,888,613,482,3006,3157,0.4877,0.5123,976,707,1207
3,Pankow,5,9,25,Komponistenviertel Weißensee,9765,751,1028,279,747,3265,1548,958,1189,5045,4720,0.5166,0.4834,1161,1307,2058
3,Pankow,5,10,17,Rennbahnstraße,4226,239,315,66,452,1301,651,611,591,2041,2185,0.483,0.517,639,381,620
3,Pankow,5,10,21,Buschallee,6494,329,409,105,446,1742,831,751,1881,3452,3042,0.5316,0.4684,538,514,843
3,Pankow,5,10,22,Hansastraße,4620,296,372,97,311,1112,597,635,1200,2532,2088,0.5481,0.4519,273,469,765
3,Pankow,6,11,26,Arnimplatz,15807,1055,1129,238,1566,7141,2404,1086,1188,7791,8016,0.4929,0.5071,3277,1367,2422
3,Pankow,6,11,31,Falkplatz,10695,784,851,143,1017,4759,1918,702,521,5272,5423,0.4929,0.5071,2512,994,1778
3,Pankow,6,12,27,Humannplatz,14642,826,953,222,1288,6359,2291,1159,1544,7482,7160,0.511,0.489,2569,1175,2001
3,Pankow,6,12,28,Erich-Weinert-Straße,12732,693,641,166,1166,5264,1612,1249,1941,6530,6202,0.5129,0.4871,2095,807,1500
3,Pankow,6,13,32,Helmholtzplatz,22788,1653,2042,493,1777,9578,4612,1683,950,11279,11509,0.495,0.505,4769,2535,4188
3,Pankow,6,14,29,Greifswalder Straße,9975,411,550,142,705,2062,1111,1115,3879,5430,4545,0.5444,0.4556,982,692,1103
3,Pankow,6,14,30,Volkspark Prenzlauer Berg,4062,282,428,117,466,1065,478,395,831,1959,2103,0.4823,0.5177,1441,545,827
3,Pankow,6,14,34,Anton-Saefkow-Park,6463,410,425,81,586,2886,928,560,587,3227,3236,0.4993,0.5007,1283,506,916
3,Pankow,6,14,35,Conrad-Blenkle-Straße,4004,256,241,81,397,1626,515,375,513,2003,2001,0.5002,0.4998,802,322,578
3,Pankow,6,14,41,Eldenaer Straße,2653,292,488,57,120,920,428,143,205,1339,1314,0.5047,0.4953,374,545,837
3,Pankow,7,15,36,Teutoburger Platz,11147,764,1006,272,1056,4476,2249,824,500,5446,5701,0.4886,0.5114,2771,1278,2042
3,Pankow,7,15,37,Kollwitzplatz,15918,1250,1366,351,1233,6314,2978,1414,1012,7844,8074,0.4928,0.5072,3817,1717,2967
3,Pankow,7,16,33,Thälmannpark,3192,207,224,62,233,1063,346,441,616,1595,1597,0.4997,0.5003,646,286,493
3,Pankow,7,16,38,Winsstraße,17743,1325,1616,371,1467,7263,3139,1384,1178,8839,8904,0.4982,0.5018,3783,1987,3312
3,Pankow,7,16,39,Bötzowstraße,12772,892,1375,295,947,4620,2540,1122,981,6451,6321,0.5051,0.4949,2188,1670,2562
4,Charlottenburg–Wilmersdorf,1,1,1,Jungfernheide,10778,591,749,220,1104,2800,1459,1418,2437,5554,5224,0.5153,0.4847,2978,969,1560
4,Charlottenburg–Wilmersdorf,1,1,2,Plötzensee,813,34,56,3,123,173,110,130,184,288,525,0.3542,0.6458,292,59,93
4,Charlottenburg–Wilmersdorf,1,1,3,Paul-Hertz-Siedlung,7899,578,706,224,727,1877,1094,947,1746,4171,3728,0.528,0.472,2181,930,1508
4,Charlottenburg–Wilmersdorf,2,2,4,Olympiagelände,188,6,37,12,14,28,37,27,27,93,95,0.4947,0.5053,37,49,55
4,Charlottenburg–Wilmersdorf,2,2,5,Siedlung Ruhleben,1311,58,103,36,132,239,184,199,360,662,649,0.505,0.495,179,139,197
4,Charlottenburg–Wilmersdorf,2,2,6,Angerburger Allee,2851,111,140,28,154,491,294,332,1301,1554,1297,0.5451,0.4549,484,168,279
4,Charlottenburg–Wilmersdorf,2,2,7,Flatowallee,2574,120,179,61,229,518,410,374,683,1326,1248,0.5152,0.4848,469,240,360
4,Charlottenburg–Wilmersdorf,2,2,8,Kranzallee,2953,121,286,110,256,429,487,452,812,1493,1460,0.5056,0.4944,411,396,517
4,Charlottenburg–Wilmersdorf,2,2,9,Eichkamp,3207,101,247,109,685,666,383,342,674,1598,1609,0.4983,0.5017,969,356,457
4,Charlottenburg–Wilmersdorf,2,3,10,Park Ruhwald,795,52,64,9,219,226,56,66,103,388,407,0.4881,0.5119,436,73,125
4,Charlottenburg–Wilmersdorf,2,3,11,Reichsstraße,15015,624,927,340,1443,3215,2096,1901,4469,7754,7261,0.5164,0.4836,3069,1267,1891
4,Charlottenburg–Wilmersdorf,2,3,12,Branitzer Platz,5542,237,398,125,483,1131,746,776,1646,2905,2637,0.5242,0.4758,1108,523,760
4,Charlottenburg–Wilmersdorf,2,3,13,Königin-Elisabeth-Straße,7304,370,366,106,860,2054,978,948,1622,3776,3528,0.517,0.483,1652,472,842
4,Charlottenburg–Wilmersdorf,2,3,14,Messegelände,12,0,0,0,3,0,0,6,3,0,12,0,1,12,0,0
4,Charlottenburg–Wilmersdorf,3,4,15,Schloßgarten,3071,114,133,44,383,903,356,373,765,1539,1532,0.5011,0.4989,1242,177,291
4,Charlottenburg–Wilmersdorf,3,4,16,Klausenerplatz,10616,670,829,294,1139,3034,1539,1450,1661,5478,5138,0.516,0.484,2832,1123,1793
4,Charlottenburg–Wilmersdorf,3,4,17,Schloßstraße,10941,557,707,223,1119,3033,1574,1511,2217,5714,5227,0.5223,0.4777,2542,930,1487
4,Charlottenburg–Wilmersdorf,3,5,18,Tegeler Weg,9581,437,480,154,1159,2950,1383,1375,1643,4881,4700,0.5094,0.4906,2622,634,1071
4,Charlottenburg–Wilmersdorf,3,5,19,Kaiserin-Augusta-Allee,5829,321,348,86,654,1947,794,784,895,2846,2983,0.4882,0.5118,1582,434,755
4,Charlottenburg–Wilmersdorf,3,6,20,Alt-Lietzow,8949,429,476,152,931,2577,1198,1179,2007,4639,4310,0.5184,0.4816,2380,628,1057
4,Charlottenburg–Wilmersdorf,3,6,21,Spreestadt,3074,140,179,48,412,1109,444,353,389,1412,1662,0.4593,0.5407,1112,227,367
4,Charlottenburg–Wilmersdorf,3,6,22,Richard-Wagner-Straße,10873,589,579,189,1094,3203,1439,1470,2310,5539,5334,0.5094,0.4906,3065,768,1357
4,Charlottenburg–Wilmersdorf,3,6,23,Ernst-Reuter-Platz,5068,305,321,79,559,1616,643,586,959,2609,2459,0.5148,0.4852,1668,400,705
4,Charlottenburg–Wilmersdorf,3,7,24,Lietzensee,6543,303,358,118,640,1631,833,932,1728,3507,3036,0.536,0.464,1529,476,779
4,Charlottenburg–Wilmersdorf,3,7,25,Amtsgerichtsplatz,12453,612,781,275,1404,3531,1800,1758,2292,6331,6122,0.5084,0.4916,3345,1056,1668
4,Charlottenburg–Wilmersdorf,3,7,26,Droysenstraße,5749,292,306,128,531,1457,840,828,1367,2982,2767,0.5187,0.4813,1623,434,726
4,Charlottenburg–Wilmersdorf,3,8,27,Karl-August-Platz,12270,606,716,218,1440,3710,1737,1646,2197,6039,6231,0.4922,0.5078,4362,934,1540
4,Charlottenburg–Wilmersdorf,3,8,28,Savignyplatz,9683,403,453,155,1032,2739,1463,1412,2026,4863,4820,0.5022,0.4978,2925,608,1011
4,Charlottenburg–Wilmersdorf,3,9,29,Hindemithplatz,6025,258,359,100,503,1565,910,985,1345,3111,2914,0.5163,0.4837,1617,459,717
4,Charlottenburg–Wilmersdorf,3,9,30,George-Grosz-Platz,5797,243,327,111,493,1379,945,893,1406,2861,2936,0.4935,0.5065,1744,438,681
4,Charlottenburg–Wilmersdorf,3,9,31,Breitscheidplatz,3725,185,225,54,300,1032,539,528,862,1800,1925,0.4832,0.5168,1472,279,464
4,Charlottenburg–Wilmersdorf,3,10,32,Halensee,15704,718,857,297,1386,4123,2210,2257,3856,8023,7681,0.5109,0.4891,4124,1154,1872
4,Charlottenburg–Wilmersdorf,4,11,33,Güterbahnhof Grunewald,68,0,0,3,16,17,9,16,7,31,37,0.4559,0.5441,33,3,3
4,Charlottenburg–Wilmersdorf,4,11,34,Bismarckallee,5247,230,444,95,417,1017,807,694,1543,2714,2533,0.5172,0.4828,1134,539,769
4,Charlottenburg–Wilmersdorf,4,11,35,Hundekehle,2832,125,213,74,180,492,386,400,962,1493,1339,0.5272,0.4728,565,287,412
4,Charlottenburg–Wilmersdorf,4,11,36,Hagenplatz,3104,149,221,84,190,570,430,433,1027,1654,1450,0.5329,0.4671,618,305,454
4,Charlottenburg–Wilmersdorf,4,11,37,Flinsberger Platz,8300,404,516,174,723,2037,1171,1154,2121,4453,3847,0.5365,0.4635,1737,690,1094
4,Charlottenburg–Wilmersdorf,4,12,38,Kissinger Straße,6116,316,528,126,496,1194,899,775,1782,3304,2812,0.5402,0.4598,1047,654,970
4,Charlottenburg–Wilmersdorf,4,12,39,Stadion Wilmersdorf,333,44,30,6,58,94,62,24,15,129,204,0.3874,0.6126,228,36,80
4,Charlottenburg–Wilmersdorf,4,12,40,Messelpark,1551,46,123,46,125,201,233,224,553,832,719,0.5364,0.4636,230,169,215
4,Charlottenburg–Wilmersdorf,4,12,41,Breite Straße,7026,303,479,134,563,1273,1044,1014,2216,3848,3178,0.5477,0.4523,972,613,916
4,Charlottenburg–Wilmersdorf,4,13,42,Schlangenbader Straße,4148,161,215,69,251,809,491,686,1466,2215,1933,0.534,0.466,767,284,445
4,Charlottenburg–Wilmersdorf,4,13,43,Binger Straße,3567,153,206,76,342,738,537,541,974,1902,1665,0.5332,0.4668,579,282,435
4,Charlottenburg–Wilmersdorf,4,13,44,Rüdesheimer Platz,10800,482,724,261,897,2311,1687,1571,2867,5864,4936,0.543,0.457,1747,985,1467
4,Charlottenburg–Wilmersdorf,5,14,45,Eisenzahnstraße,6354,329,386,140,613,1698,895,904,1389,3324,3030,0.5231,0.4769,1500,526,855
4,Charlottenburg–Wilmersdorf,5,14,46,Preußenpark,10866,521,657,199,881,2694,1534,1627,2753,5537,5329,0.5096,0.4904,2802,856,1377
4,Charlottenburg–Wilmersdorf,5,14,47,Ludwigkirchplatz,5354,232,301,102,475,1326,755,748,1415,2814,2540,0.5256,0.4744,1330,403,635
4,Charlottenburg–Wilmersdorf,5,14,48,Schaperstraße,9480,397,508,137,798,2499,1403,1362,2376,4759,4721,0.502,0.498,2931,645,1042
4,Charlottenburg–Wilmersdorf,5,15,49,Rathaus Wilmersdorf,4660,269,339,102,533,1339,611,616,851,2344,2316,0.503,0.497,1277,441,710
4,Charlottenburg–Wilmersdorf,5,15,50,Leon-Jessel-Platz,5598,262,381,109,621,1534,855,775,1061,2840,2758,0.5073,0.4927,1432,490,752
4,Charlottenburg–Wilmersdorf,5,15,51,Brabanter Platz,4523,231,289,109,510,1279,612,639,854,2304,2219,0.5094,0.4906,1145,398,629
4,Charlottenburg–Wilmersdorf,5,16,52,Nikolsburger Platz,9933,443,619,218,912,2474,1447,1378,2442,5214,4719,0.5249,0.4751,2504,837,1280
4,Charlottenburg–Wilmersdorf,5,16,53,Prager Platz,7029,306,406,141,669,1757,1025,969,1756,3555,3474,0.5058,0.4942,1844,547,853
4,Charlottenburg–Wilmersdorf,5,16,54,Wilhelmsaue,3048,116,158,39,272,762,393,433,875,1623,1425,0.5325,0.4675,651,197,313
4,Charlottenburg–Wilmersdorf,5,16,55,Babelsberger Straße,7418,370,477,146,823,2193,1022,957,1430,3739,3679,0.504,0.496,1926,623,993
4,Charlottenburg–Wilmersdorf,5,16,56,Hildegardstraße,7717,386,562,179,807,2172,1127,1027,1457,3959,3758,0.513,0.487,1499,741,1127
4,Charlottenburg–Wilmersdorf,6,17,57,Forst Grunewald,67,0,0,0,9,7,3,30,18,21,46,0.3134,0.6866,12,0,0
5,Spandau,1,1,1,Hakenfelde Nord,10509,665,844,256,892,2504,1381,1320,2647,5562,4947,0.5293,0.4707,1479,1100,1765
5,Spandau,1,1,2,Goltzstraße,8096,577,497,157,905,2158,912,1044,1846,4163,3933,0.5142,0.4858,1753,654,1231
5,Spandau,1,1,3,Amorbacher Weg,7648,341,517,182,709,1602,1076,1246,1975,3925,3723,0.5132,0.4868,682,699,1040
5,Spandau,1,2,4,Griesingerstraße,3604,250,422,136,360,719,371,449,897,1940,1664,0.5383,0.4617,892,558,808
5,Spandau,1,2,5,An der Tränke,2132,76,156,68,290,423,407,424,288,1070,1062,0.5019,0.4981,254,224,300
5,Spandau,1,2,6,Gütersloher Weg,10613,686,944,308,1016,2352,1312,1372,2623,5458,5155,0.5143,0.4857,2312,1252,1938
5,Spandau,1,2,7,Darbystraße,11558,787,1169,390,1063,2633,1458,1544,2514,6053,5505,0.5237,0.4763,2668,1559,2346
5,Spandau,1,2,8,Germersheimer Platz,7706,481,559,152,837,2119,1090,1050,1418,3952,3754,0.5128,0.4872,1627,711,1192
5,Spandau,1,2,9,An der Kappe,6059,303,437,140,553,1191,906,921,1608,3079,2980,0.5082,0.4918,913,577,880
5,Spandau,1,3,10,Eckschanze,3983,275,303,94,458,1123,547,511,672,2031,1952,0.5099,0.4901,927,397,672
5,Spandau,1,3,11,Eiswerder,5647,322,536,177,526,1235,669,599,1583,2996,2651,0.5305,0.4695,1358,713,1035
5,Spandau,1,3,12,Kurstraße,7426,571,725,204,959,2354,941,805,867,3455,3971,0.4653,0.5347,3061,929,1500
5,Spandau,1,3,13,Ackerstraße,6854,461,490,174,917,2010,972,910,920,3315,3539,0.4837,0.5163,1850,664,1125
5,Spandau,1,3,14,Carl-Schurz-Straße,12390,806,871,296,1464,3517,1701,1635,2100,6236,6154,0.5033,0.4967,2877,1167,1973
5,Spandau,1,3,39,Freiheit,995,101,175,32,126,273,125,64,99,456,539,0.4583,0.5417,610,207,308
5,Spandau,2,4,15,Isenburger Weg,3818,163,328,141,430,571,780,821,584,1895,1923,0.4963,0.5037,231,469,632
5,Spandau,2,4,16,Am Heideberg,1679,57,90,30,140,283,241,260,578,866,813,0.5158,0.4842,34,120,177
5,Spandau,2,4,17,Staakener Straße,5929,277,440,175,585,1105,949,946,1452,2927,3002,0.4937,0.5063,938,615,892
5,Spandau,2,4,18,Spandauer Straße,4398,278,430,147,503,1008,554,497,981,2212,2186,0.503,0.497,711,577,855
5,Spandau,2,4,19,Magistratsweg,7164,480,607,156,627,1582,848,892,1972,3837,3327,0.5356,0.4644,1106,763,1243
5,Spandau,2,4,20,Werkstraße,965,74,91,30,109,221,168,135,137,475,490,0.4922,0.5078,98,121,195
5,Spandau,2,5,21,Döberitzer Weg,3251,214,376,100,345,710,547,419,540,1700,1551,0.5229,0.4771,326,476,690
5,Spandau,2,5,22,Pillnitzer Weg,7577,569,900,241,770,1868,945,870,1414,3870,3707,0.5108,0.4892,2326,1141,1710
5,Spandau,2,5,23,Maulbeerallee,12696,1160,1658,517,1388,2998,1452,1312,2211,6514,6182,0.5131,0.4869,3888,2175,3335
5,Spandau,2,5,24,Weinmeisterhornweg,6313,301,351,121,500,1105,810,1046,2079,3302,3011,0.523,0.477,659,472,773
5,Spandau,2,6,25,Borkumer Straße,7614,416,475,167,797,1951,947,955,1906,3891,3723,0.511,0.489,1662,642,1058
5,Spandau,2,6,26,Adamstraße,18203,1017,1286,387,2019,5048,2697,2413,3336,9215,8988,0.5062,0.4938,3864,1673,2690
5,Spandau,2,6,27,Tiefwerder,4409,272,444,148,521,1071,589,551,813,2206,2203,0.5003,0.4997,1274,592,864
5,Spandau,2,6,28,Graetschelsteig,2013,107,142,39,149,365,212,281,718,1126,887,0.5594,0.4406,226,181,288
5,Spandau,2,6,29,Börnicker Straße,4412,136,234,76,239,611,628,714,1774,2305,2107,0.5224,0.4776,319,310,446
5,Spandau,3,7,30,Zitadellenweg,4030,325,496,169,430,1018,667,431,494,2015,2015,0.5,0.5,742,665,990
5,Spandau,3,7,31,Gartenfelder Straße,11661,687,866,275,1078,2863,1526,1663,2703,6128,5533,0.5255,0.4745,2405,1141,1828
5,Spandau,3,8,32,Rohrdamm,12286,765,1087,290,1416,3329,1658,1534,2207,6081,6205,0.495,0.505,3277,1377,2142
5,Spandau,3,8,33,Motardstraße,505,34,30,18,64,137,65,59,98,258,247,0.5109,0.4891,117,48,82
5,Spandau,4,9,34,Alt-Gatow,3457,150,302,123,315,498,468,557,1044,1707,1750,0.4938,0.5062,501,425,575
5,Spandau,4,9,35,Groß-Glienicker Weg,459,22,33,15,36,64,91,77,121,227,232,0.4946,0.5054,71,48,70
5,Spandau,4,9,36,Jägerallee,10041,627,1194,351,721,1874,1682,1406,2186,5078,4963,0.5057,0.4943,589,1545,2172
5,Spandau,4,9,37,Kladower Damm,2199,91,171,69,144,288,276,398,762,1107,1092,0.5034,0.4966,131,240,331
5,Spandau,4,9,38,Kafkastraße,3678,174,316,122,243,526,513,571,1213,1899,1779,0.5163,0.4837,186,438,612
6,Steglitz–Zehlendorf,1,1,1,Fichtenberg,6934,308,488,207,640,1298,989,978,2026,3738,3196,0.5391,0.4609,931,695,1003
6,Steglitz–Zehlendorf,1,1,2,Schloßstraße,8818,531,565,180,905,2487,1181,1271,1698,4641,4177,0.5263,0.4737,1709,745,1276
6,Steglitz–Zehlendorf,1,1,3,Markelstraße,6375,392,397,151,612,1857,953,814,1199,3383,2992,0.5307,0.4693,1030,548,940
6,Steglitz–Zehlendorf,1,2,4,Munsterdamm,6864,322,489,177,705,1672,980,933,1586,3607,3257,0.5255,0.4745,1157,666,988
6,Steglitz–Zehlendorf,1,2,5,Südende,9903,556,694,182,1019,2714,1405,1368,1965,5158,4745,0.5209,0.4791,1702,876,1432
6,Steglitz–Zehlendorf,1,2,6,Stadtpark,7795,445,538,162,660,1961,1065,1009,1955,4209,3586,0.54,0.46,1180,700,1145
6,Steglitz–Zehlendorf,1,2,7,Mittelstraße,7908,429,507,151,850,2117,1071,1059,1724,4136,3772,0.523,0.477,1371,658,1087
6,Steglitz–Zehlendorf,1,2,8,Bergstraße,6735,379,410,106,674,1826,929,1000,1411,3458,3277,0.5134,0.4866,1057,516,895
6,Steglitz–Zehlendorf,1,2,9,Feuerbachstraße,9200,517,525,146,905,2668,1295,1265,1879,4928,4272,0.5357,0.4643,1665,671,1188
6,Steglitz–Zehlendorf,1,2,10,Bismarckstraße,4896,286,329,93,415,1300,726,716,1031,2581,2315,0.5272,0.4728,726,422,708
6,Steglitz–Zehlendorf,2,3,1,Alt-Lankwitz,5013,256,333,122,419,982,701,674,1526,2633,2380,0.5252,0.4748,542,455,711
6,Steglitz–Zehlendorf,2,3,2,Komponistenviertel Lankwitz,5937,297,416,124,487,1222,825,768,1798,3084,2853,0.5195,0.4805,946,540,837
6,Steglitz–Zehlendorf,2,3,3,Lankwitz Kirche,7348,402,492,135,680,2019,967,1056,1597,3940,3408,0.5362,0.4638,1179,627,1029
6,Steglitz–Zehlendorf,2,3,4,Kaiser-Wilhelm-Straße,7249,411,461,137,687,1912,1030,986,1625,3816,3433,0.5264,0.4736,1103,598,1009
6,Steglitz–Zehlendorf,2,3,5,Gemeindepark Lankwitz,11363,568,920,263,1227,2577,1465,1445,2898,6078,5285,0.5349,0.4651,2010,1183,1751
6,Steglitz–Zehlendorf,2,3,6,Lankwitz Süd,6402,322,454,147,555,1102,1025,1013,1784,3318,3084,0.5183,0.4817,541,601,923
6,Steglitz–Zehlendorf,2,4,7,Thermometersiedlung,4631,265,398,115,451,1102,557,503,1240,2370,2261,0.5118,0.4882,1175,513,778
6,Steglitz–Zehlendorf,2,4,8,Lichterfelde Süd,6906,366,524,157,628,1396,952,946,1937,3592,3314,0.5201,0.4799,1042,681,1047
6,Steglitz–Zehlendorf,2,4,9,Königsberger Straße,8408,408,631,195,675,1662,1142,1116,2579,4498,3910,0.535,0.465,1202,826,1234
6,Steglitz–Zehlendorf,2,4,10,Oberhofer Platz,7183,354,549,203,696,1348,1070,1014,1949,3809,3374,0.5303,0.4697,852,752,1106
6,Steglitz–Zehlendorf,2,4,11,Schütte-Lanz-Straße,8561,429,720,267,666,1482,1212,1292,2493,4551,4010,0.5316,0.4684,1011,987,1416
6,Steglitz–Zehlendorf,3,5,1,Berlepschstraße,5725,241,481,173,566,929,829,750,1756,2891,2834,0.505,0.495,843,654,895
6,Steglitz–Zehlendorf,3,5,2,Zehlendorf Süd,5609,305,381,132,482,1204,828,875,1402,3096,2513,0.552,0.448,696,513,818
6,Steglitz–Zehlendorf,3,5,3,Zehlendorf Mitte,11816,615,873,274,1088,2552,1751,1695,2968,6298,5518,0.533,0.467,1778,1147,1762
6,Steglitz–Zehlendorf,3,5,4,Teltower Damm,11081,507,953,330,806,1706,1545,1529,3705,5932,5149,0.5353,0.4647,1245,1283,1790
6,Steglitz–Zehlendorf,3,6,5,Botanischer Garten,7184,337,504,152,723,1656,1058,1004,1750,3726,3458,0.5187,0.4813,1095,656,993
6,Steglitz–Zehlendorf,3,6,6,Hindenburgdamm,5483,307,454,147,621,1326,760,731,1137,2822,2661,0.5147,0.4853,1227,601,908
6,Steglitz–Zehlendorf,3,6,7,Goerzwerke,3102,139,234,81,492,712,419,376,649,1568,1534,0.5055,0.4945,785,315,454
6,Steglitz–Zehlendorf,3,6,8,Schweizer Viertel,13681,801,1438,460,1167,2694,2216,1823,3082,6913,6768,0.5053,0.4947,1879,1898,2699
6,Steglitz–Zehlendorf,3,6,9,Augustaplatz,12197,619,1018,321,1115,2554,1821,1804,2945,6380,5817,0.5231,0.4769,1656,1339,1958
6,Steglitz–Zehlendorf,3,6,10,Lichterfelde West,8469,419,770,280,670,1523,1330,1188,2289,4512,3957,0.5328,0.4672,1065,1050,1469
6,Steglitz–Zehlendorf,4,7,1,Wannsee,10270,512,951,301,701,1639,1630,1460,3076,5246,5024,0.5108,0.4892,1273,1252,1764
6,Steglitz–Zehlendorf,4,7,2,Düppel,5495,291,550,213,429,916,841,788,1467,2820,2675,0.5132,0.4868,652,763,1054
6,Steglitz–Zehlendorf,4,7,3,Nikolassee,11199,486,943,302,1520,1953,1507,1467,3021,5786,5413,0.5167,0.4833,2282,1245,1731
6,Steglitz–Zehlendorf,4,8,4,Krumme Lanke,7588,322,666,241,569,1039,1157,1136,2458,4023,3565,0.5302,0.4698,713,907,1229
6,Steglitz–Zehlendorf,4,8,5,Fischerhüttenstraße,5295,225,456,166,407,785,835,772,1649,2874,2421,0.5428,0.4572,581,622,847
6,Steglitz–Zehlendorf,4,8,6,Fischtal,7319,314,627,260,654,1089,1151,1074,2150,3982,3337,0.5441,0.4559,608,887,1201
6,Steglitz–Zehlendorf,4,8,7,Zehlendorf Eiche,5919,245,487,172,478,1019,784,762,1972,3328,2591,0.5623,0.4377,723,659,904
6,Steglitz–Zehlendorf,4,8,8,Hüttenweg,4698,334,588,173,406,973,873,589,762,2424,2274,0.516,0.484,665,761,1095
6,Steglitz–Zehlendorf,4,8,9,Thielallee,4984,202,494,199,479,748,850,708,1304,2606,2378,0.5229,0.4771,922,693,895
6,Steglitz–Zehlendorf,4,8,10,Dahlem,7154,346,639,262,693,1175,1059,921,2059,3739,3415,0.5226,0.4774,1276,901,1247
7,Tempelhof–Schöneberg,1,1,1,Wittenbergplatz/Viktoria-Luise-Platz,9949,415,501,159,826,2590,1578,1540,2340,4742,5207,0.4766,0.5234,2926,660,1075
7,Tempelhof–Schöneberg,1,1,2,Nollendorfplatz,16693,857,1197,423,1887,4777,2530,2293,2729,7681,9012,0.4601,0.5399,5895,1620,2477
7,Tempelhof–Schöneberg,1,1,3,Barbarossaplatz,10619,568,702,221,1068,3122,1591,1568,1779,5237,5382,0.4932,0.5068,2561,923,1491
7,Tempelhof–Schöneberg,1,1,4,Dennewitzplatz,13943,778,1016,314,1570,4501,2146,1857,1761,6661,7282,0.4777,0.5223,4855,1330,2108
7,Tempelhof–Schöneberg,2,2,1,Bayerischer Platz,10664,479,642,206,1024,2781,1612,1569,2351,5500,5164,0.5158,0.4842,2110,848,1327
7,Tempelhof–Schöneberg,2,2,2,Volkspark (Rudolf-Wilde-Park),10358,648,610,206,1127,3531,1346,1237,1653,5081,5277,0.4905,0.5095,2734,816,1464
7,Tempelhof–Schöneberg,2,2,3,Kaiser-Wilhelm-Platz,18022,1033,1214,396,1923,5784,2679,2461,2532,8942,9080,0.4962,0.5038,4746,1610,2643
7,Tempelhof–Schöneberg,2,2,4,Schöneberger Insel,12243,779,785,205,1342,4430,1849,1609,1244,6139,6104,0.5014,0.4986,2698,990,1769
7,Tempelhof–Schöneberg,3,3,1,Friedenau,24824,1269,1978,616,2348,6077,3832,3626,5078,13237,11587,0.5332,0.4668,3889,2594,3863
7,Tempelhof–Schöneberg,3,3,2,Ceciliengärten,9442,502,652,244,995,2385,1375,1439,1850,4925,4517,0.5216,0.4784,1627,896,1398
7,Tempelhof–Schöneberg,3,3,3,Grazer Platz,12409,778,940,311,1418,3587,1816,1659,1900,6385,6024,0.5145,0.4855,2827,1251,2029
7,Tempelhof–Schöneberg,4,4,1,Neu-Tempelhof,17860,1047,1467,460,1722,4602,2612,2471,3479,9253,8607,0.5181,0.4819,3489,1927,2974
7,Tempelhof–Schöneberg,4,4,2,Lindenhofsiedlung,2328,119,157,42,154,440,325,386,705,1211,1117,0.5202,0.4798,222,199,318
7,Tempelhof–Schöneberg,4,4,3,Manteuffelstraße,24572,1538,1601,504,2581,7599,3257,3103,4389,12735,11837,0.5183,0.4817,5195,2105,3643
7,Tempelhof–Schöneberg,4,4,4,Marienhöhe,5177,280,314,83,510,1129,703,726,1432,2739,2438,0.5291,0.4709,667,397,677
7,Tempelhof–Schöneberg,4,4,5,Rathaus Tempelhof,11316,700,860,229,1387,3321,1443,1350,2026,5746,5570,0.5078,0.4922,2933,1089,1789
7,Tempelhof–Schöneberg,4,4,6,Germaniagarten,4058,313,294,61,479,1492,514,441,464,1952,2106,0.481,0.519,1453,355,668
7,Tempelhof–Schöneberg,5,5,1,Rathausstraße,17038,1081,1100,353,1782,4741,2156,2182,3643,8716,8322,0.5116,0.4884,3671,1453,2534
7,Tempelhof–Schöneberg,5,5,2,Fritz-Werner-Straße,8051,376,474,180,791,1933,1032,1065,2200,4186,3865,0.5199,0.4801,1651,654,1030
7,Tempelhof–Schöneberg,5,5,3,Eisenacher Straße,9263,487,527,152,766,2344,1193,1333,2461,4920,4343,0.5311,0.4689,1503,679,1166
7,Tempelhof–Schöneberg,5,5,4,Imbrosweg,5644,309,397,133,564,1245,778,816,1402,2923,2721,0.5179,0.4821,845,530,839
7,Tempelhof–Schöneberg,5,5,5,Hundsteinweg,10689,541,751,267,952,2055,1433,1377,3313,5646,5043,0.5282,0.4718,1450,1018,1559
7,Tempelhof–Schöneberg,5,5,6,Birnhornweg,2278,98,183,59,199,414,350,339,636,1133,1145,0.4974,0.5026,230,242,340
7,Tempelhof–Schöneberg,6,6,1,Marienfelder Allee Nordwest,10259,699,960,332,1054,2289,1362,1209,2354,5171,5088,0.504,0.496,2394,1292,1991
7,Tempelhof–Schöneberg,6,6,2,Kirchstraße,4757,213,405,132,400,909,778,680,1240,2355,2402,0.4951,0.5049,506,537,750
7,Tempelhof–Schöneberg,6,6,3,Marienfelde Nordost,2878,168,260,93,223,531,327,387,889,1495,1383,0.5195,0.4805,502,353,521
7,Tempelhof–Schöneberg,6,6,4,Marienfelde Süd,14560,866,1154,376,1281,3191,1690,1923,4079,7686,6874,0.5279,0.4721,2221,1530,2396
7,Tempelhof–Schöneberg,7,7,1,Kettinger Straße/Schillerstraße,10512,543,792,299,887,1959,1560,1528,2944,5473,5039,0.5206,0.4794,1041,1091,1634
7,Tempelhof–Schöneberg,7,7,2,Alt-Lichtenrade/Töpchiner Weg,10978,647,906,296,848,2136,1659,1607,2879,5679,5299,0.5173,0.4827,934,1202,1849
7,Tempelhof–Schöneberg,7,7,3,John-Locke-Straße,7780,384,571,189,678,1459,1088,1037,2374,4118,3662,0.5293,0.4707,925,760,1144
7,Tempelhof–Schöneberg,7,7,4,Nahariyastraße,8572,578,923,318,873,1749,1074,1037,2020,4411,4161,0.5146,0.4854,1935,1241,1819
7,Tempelhof–Schöneberg,7,7,5,Franziusweg/Rohrbachstraße,7023,371,535,232,615,1277,1135,1096,1762,3592,3431,0.5115,0.4885,556,767,1138
7,Tempelhof–Schöneberg,7,7,6,Horstwalder Straße/Paplitzer Straße,3900,230,343,105,307,736,496,554,1129,2052,1848,0.5262,0.4738,486,448,678
7,Tempelhof–Schöneberg,7,7,7,Wittelsbacherstraße,2985,194,253,56,219,479,453,439,892,1545,1440,0.5176,0.4824,257,309,503
8,Neukölln,1,1,15,Hasenheide,899,68,67,15,65,298,134,136,116,416,483,0.4627,0.5373,253,82,150
8,Neukölln,1,1,16,Wissmannstraße,3668,192,224,79,391,1515,501,440,326,1718,1950,0.4684,0.5316,1426,303,495
8,Neukölln,1,1,17,Schillerpromenade,16010,957,975,254,1536,7472,1865,1535,1416,7664,8346,0.4787,0.5213,5424,1229,2186
8,Neukölln,1,1,18,Silbersteinstraße,11796,751,990,305,1392,4700,1366,1009,1283,5732,6064,0.4859,0.5141,4362,1295,2046
8,Neukölln,1,2,11,Flughafenstraße,9910,557,657,200,1072,4428,1146,950,900,4796,5114,0.484,0.516,3839,857,1414
8,Neukölln,1,2,12,Rollberg,7434,476,791,267,825,2324,946,771,1034,3676,3758,0.4945,0.5055,2523,1058,1534
8,Neukölln,1,2,13,Körnerpark,12276,777,851,253,1414,5264,1469,1074,1174,5976,6300,0.4868,0.5132,4246,1104,1881
8,Neukölln,1,2,14,Glasower Straße,8378,443,630,250,1163,3095,1033,822,942,3993,4385,0.4766,0.5234,3246,880,1323
8,Neukölln,1,3,1,Reuterkiez,27496,1696,1719,424,2402,12495,3657,2672,2431,13732,13764,0.4994,0.5006,8608,2143,3839
8,Neukölln,1,3,2,Bouchéstraße,3797,194,227,75,358,1213,562,537,631,1901,1896,0.5007,0.4993,847,302,496
8,Neukölln,1,3,3,Donaustraße,8388,491,598,141,933,3893,953,709,670,3993,4395,0.476,0.524,3365,739,1230
8,Neukölln,1,4,4,Rixdorf,23507,1543,1637,463,2541,10392,2593,2241,2097,11325,12182,0.4818,0.5182,7989,2100,3643
8,Neukölln,1,4,5,Hertzbergplatz,8951,516,557,160,933,3868,1030,834,1053,4551,4400,0.5084,0.4916,2742,717,1233
8,Neukölln,1,4,6,Treptower Straße Nord,7122,589,679,173,770,2680,764,667,800,3473,3649,0.4876,0.5124,2791,852,1441
8,Neukölln,1,4,7,Gewerbegebiet Ederstraße,796,43,27,8,102,396,104,63,53,391,405,0.4912,0.5088,235,35,78
8,Neukölln,1,5,8,Weiße Siedlung,5824,603,712,189,771,1494,727,589,739,2873,2951,0.4933,0.5067,2088,901,1504
8,Neukölln,1,5,9,Schulenburgpark,9393,782,1287,331,1153,2352,1199,945,1344,4674,4719,0.4976,0.5024,2748,1618,2400
8,Neukölln,1,5,10,Gewerbegebiet Köllnische Heide,481,32,29,12,62,197,75,49,25,201,280,0.4179,0.5821,239,41,73
8,Neukölln,2,6,19,Buschkrugallee Nord,11542,880,1082,295,1375,3392,1491,1303,1724,5536,6006,0.4796,0.5204,3811,1377,2257
8,Neukölln,2,6,20,Tempelhofer Weg,9261,551,668,193,998,2531,1219,1200,1901,4780,4481,0.5161,0.4839,2022,861,1412
8,Neukölln,2,6,21,Mohriner Allee Nord,2343,111,206,64,201,408,371,448,534,1195,1148,0.51,0.49,204,270,381
8,Neukölln,2,6,22,Parchimer Allee,14267,788,952,312,1312,3398,1990,2165,3350,7501,6766,0.5258,0.4742,1913,1264,2052
8,Neukölln,2,6,23,Ortolanweg,1253,55,74,28,97,226,178,217,378,661,592,0.5275,0.4725,165,102,157
8,Neukölln,2,6,24,Britzer Garten,1402,94,162,40,108,355,237,185,221,684,718,0.4879,0.5121,174,202,296
8,Neukölln,2,6,25,Handwerker-Siedlung,3287,110,242,90,348,615,496,478,908,1567,1720,0.4767,0.5233,519,332,442
8,Neukölln,2,7,26,Buckow West,8435,423,576,206,735,1761,1275,1254,2205,4371,4064,0.5182,0.4818,972,782,1205
8,Neukölln,2,7,27,Buckow Mitte,11930,601,960,326,1208,2277,1610,1637,3311,6198,5732,0.5195,0.4805,1789,1286,1887
8,Neukölln,2,7,28,Buckow Ost,8953,587,827,262,1024,2016,1168,1086,1983,4444,4509,0.4964,0.5036,2065,1089,1676
8,Neukölln,3,8,29,Gropiusstadt Nord,12479,817,1038,333,1237,2645,1439,1570,3400,6644,5835,0.5324,0.4676,2597,1371,2188
8,Neukölln,3,8,30,Gropiusstadt Süd,7316,378,447,124,548,1461,849,966,2543,3907,3409,0.534,0.466,1188,571,949
8,Neukölln,3,8,31,Gropiusstadt Ost,17522,1198,1481,493,1797,3929,2146,2224,4254,9143,8379,0.5218,0.4782,3667,1974,3172
8,Neukölln,4,9,32,Goldhähnchenweg,2848,196,256,80,201,531,303,358,923,1517,1331,0.5327,0.4673,390,336,532
8,Neukölln,4,9,33,Vogelviertel Süd,4173,184,217,83,406,804,604,597,1278,2153,2020,0.5159,0.4841,584,300,484
8,Neukölln,4,9,34,Vogelviertel Nord,2679,132,207,76,263,576,387,414,624,1372,1307,0.5121,0.4879,356,283,415
8,Neukölln,4,10,35,Blumenviertel,8297,465,632,282,769,1482,1291,1205,2171,4155,4142,0.5008,0.4992,1233,914,1379
8,Neukölln,4,10,36,Zittauer Straße,6840,310,518,173,616,1160,1030,1128,1905,3455,3385,0.5051,0.4949,664,691,1001
8,Neukölln,4,10,37,Alt-Rudow,9925,566,724,217,913,1865,1408,1535,2697,5082,4843,0.512,0.488,1247,941,1507
8,Neukölln,4,10,38,Waßmannsdorfer Chaussee,7054,391,572,191,600,1246,1044,1038,1972,3621,3433,0.5133,0.4867,530,763,1154
8,Neukölln,4,10,39,Frauenviertel,3819,273,302,117,403,948,617,490,669,2029,1790,0.5313,0.4687,376,419,692
8,Neukölln,4,10,40,Waltersdorfer Chaussee Ost,7940,513,651,265,751,1549,1138,1187,1886,4168,3772,0.5249,0.4751,806,916,1429
9,Treptow–Köpenick,1,1,1,Elsenstraße,12560,955,1042,226,919,5069,1843,1199,1307,6251,6309,0.4977,0.5023,2391,1268,2223
9,Treptow–Köpenick,1,1,2,Am Treptower Park Nord,75,3,9,3,6,27,18,6,3,36,39,0.48,0.52,15,12,15
9,Treptow–Köpenick,1,2,1,Am Treptower Park Süd,4372,333,380,85,274,1429,673,440,758,2250,2122,0.5146,0.4854,411,465,798
9,Treptow–Köpenick,1,2,2,Köpenicker Landstraße,6939,345,253,82,633,2129,831,888,1778,3593,3346,0.5178,0.4822,779,335,680
9,Treptow–Köpenick,1,3,1,Baumschulenstraße,15690,861,820,218,1272,5255,1797,1646,3821,8202,7488,0.5228,0.4772,1494,1038,1899
9,Treptow–Köpenick,1,3,2,Späthsfelde,3148,195,311,112,278,553,537,520,642,1579,1569,0.5016,0.4984,546,423,618
9,Treptow–Köpenick,1,4,1,Johannisthal West,8439,441,462,131,580,1927,1045,1057,2796,4478,3961,0.5306,0.4694,511,593,1034
9,Treptow–Köpenick,1,4,2,Johannisthal Ost,11401,710,940,332,974,3188,1761,1547,1949,5811,5590,0.5097,0.4903,823,1272,1982
9,Treptow–Köpenick,2,5,1,Oberschöneweide West,7534,580,521,152,1143,2971,795,647,725,3559,3975,0.4724,0.5276,1702,673,1253
9,Treptow–Köpenick,2,5,2,Oberschöneweide Ost,15752,1153,1122,303,2108,5469,1843,1604,2150,7785,7967,0.4942,0.5058,2298,1425,2578
9,Treptow–Köpenick,2,6,1,Schnellerstraße,8993,702,632,157,1211,3330,946,782,1233,4341,4652,0.4827,0.5173,2007,789,1491
9,Treptow–Köpenick,2,6,2,Oberspree,3569,157,262,73,224,739,461,543,1110,1826,1743,0.5116,0.4884,148,335,492
9,Treptow–Köpenick,2,7,1,Adlershof West,2772,268,127,18,610,1175,173,199,202,1303,1469,0.4701,0.5299,810,145,413
9,Treptow–Köpenick,2,7,2,Adlershof Ost,16813,1055,1145,326,1683,5064,2193,2053,3294,8438,8375,0.5019,0.4981,2005,1471,2526
9,Treptow–Köpenick,2,8,1,Spindlersfeld,2975,208,235,30,200,950,420,377,555,1525,1450,0.5126,0.4874,183,265,473
9,Treptow–Köpenick,2,8,2,Köllnische Vorstadt,7959,602,753,214,733,2445,944,937,1331,3970,3989,0.4988,0.5012,1105,967,1569
9,Treptow–Köpenick,3,9,1,Dorf Altglienicke,13611,887,1229,335,981,3146,2249,2156,2628,6898,6713,0.5068,0.4932,848,1564,2451
9,Treptow–Köpenick,3,9,2,Wohngebiet II,5623,389,555,171,514,1352,842,885,915,2911,2712,0.5177,0.4823,415,726,1115
9,Treptow–Köpenick,3,9,3,Kölner Viertel,8159,672,915,270,704,2054,1306,1092,1146,4060,4099,0.4976,0.5024,708,1185,1857
9,Treptow–Köpenick,3,10,1,Bohnsdorf,13134,704,1067,325,964,2831,2156,2146,2941,6612,6522,0.5034,0.4966,1087,1392,2096
9,Treptow–Köpenick,3,11,1,Grünau,6634,418,410,107,426,1673,953,908,1739,3406,3228,0.5134,0.4866,559,517,935
9,Treptow–Köpenick,3,12,1,Karolinenhof,1821,79,142,42,85,319,280,293,581,934,887,0.5129,0.4871,59,184,263
9,Treptow–Köpenick,3,12,2,Schmöckwitz/Rauchfangswerder,2573,159,193,64,172,500,453,412,620,1287,1286,0.5002,0.4998,139,257,416
9,Treptow–Köpenick,4,13,1,Kietzer Feld/Nachtheide,10088,394,576,145,527,1838,1448,1757,3403,5284,4804,0.5238,0.4762,277,721,1115
9,Treptow–Köpenick,4,13,2,Wendenschloß,1919,117,157,43,93,349,316,319,525,982,937,0.5117,0.4883,97,200,317
9,Treptow–Köpenick,4,14,1,Allende I,5481,264,284,91,272,1061,515,631,2363,3007,2474,0.5486,0.4514,205,375,639
9,Treptow–Köpenick,4,14,3,Allende II,4596,177,312,123,368,988,460,651,1517,2262,2334,0.4922,0.5078,517,435,612
9,Treptow–Köpenick,4,15,1,Altstadt Kietz,7136,530,695,207,655,2238,910,915,986,3605,3531,0.5052,0.4948,859,902,1432
9,Treptow–Köpenick,4,16,1,Müggelheim,6760,320,523,162,361,1268,1152,1265,1709,3351,3409,0.4957,0.5043,216,685,1005
9,Treptow–Köpenick,5,17,1,Hirschgarten,4090,249,239,70,302,960,537,527,1206,2117,1973,0.5176,0.4824,289,309,558
9,Treptow–Köpenick,5,17,2,Bölschestraße,15049,839,1188,377,724,3160,2259,2018,4484,8181,6868,0.5436,0.4564,623,1565,2404
9,Treptow–Köpenick,5,18,1,Rahnsdorf/Hessenwinkel,9495,474,792,245,471,1664,1559,1649,2641,4751,4744,0.5004,0.4996,497,1037,1511
9,Treptow–Köpenick,5,19,1,Dammvorstadt,11473,772,681,216,958,3700,1373,1373,2400,5904,5569,0.5146,0.4854,949,897,1669
9,Treptow–Köpenick,5,20,1,Köpenick Nord,12970,612,838,248,920,2788,1752,1855,3957,6905,6065,0.5324,0.4676,552,1086,1698
10,Marzahn–Hellersdorf,1,1,1,Marzahn West,5691,416,552,159,461,1675,681,1006,741,2884,2807,0.5068,0.4932,804,711,1127
10,Marzahn–Hellersdorf,1,1,2,Havemannstraße,18274,1285,1934,551,1702,4881,2056,3190,2675,9000,9274,0.4925,0.5075,2248,2485,3770
10,Marzahn–Hellersdorf,1,2,3,Gewerbegebiet Bitterfelder Straße,1168,91,90,25,243,431,143,93,52,295,873,0.2526,0.7474,667,115,206
10,Marzahn–Hellersdorf,1,2,4,Wuhletalstraße,10693,771,1044,309,846,2863,1020,1653,2187,5499,5194,0.5143,0.4857,1233,1353,2124
10,Marzahn–Hellersdorf,1,2,5,Marzahn Ost,8141,515,762,209,655,2409,870,1368,1353,4021,4120,0.4939,0.5061,720,971,1486
10,Marzahn–Hellersdorf,1,2,6,Ringkolonnaden,17291,981,1373,380,1453,4405,1651,2661,4387,8603,8688,0.4975,0.5025,2484,1753,2734
10,Marzahn–Hellersdorf,1,2,7,Marzahner Promenade,10636,581,864,274,864,2501,1036,1564,2952,5446,5190,0.512,0.488,1149,1138,1719
10,Marzahn–Hellersdorf,1,3,8,Marzahner Chaussee,2182,131,151,43,172,576,282,343,484,982,1200,0.45,0.55,341,194,325
10,Marzahn–Hellersdorf,1,3,9,Springpfuhl,14638,736,1060,291,1102,3620,1454,2026,4349,7561,7077,0.5165,0.4835,1471,1351,2087
10,Marzahn–Hellersdorf,1,3,10,Alt-Marzahn,18013,976,1396,382,1337,4217,1844,2649,5212,9097,8916,0.505,0.495,1921,1778,2754
10,Marzahn–Hellersdorf,1,3,11,Landsberger Tor,3688,276,291,73,193,993,391,512,959,2033,1655,0.5512,0.4488,180,364,640
10,Marzahn–Hellersdorf,2,4,12,Alte Hellersdorfer Straße,7186,703,945,237,724,2139,810,958,670,3669,3517,0.5106,0.4894,1240,1182,1885
10,Marzahn–Hellersdorf,2,4,13,Gut Hellersdorf,16195,1240,1430,355,1521,4852,1892,2656,2249,8260,7935,0.51,0.49,2453,1785,3025
10,Marzahn–Hellersdorf,2,4,14,Helle Mitte,1694,106,168,58,167,555,187,204,249,865,829,0.5106,0.4894,355,226,332
10,Marzahn–Hellersdorf,2,4,15,Hellersdorfer Promenade,5830,505,681,180,579,1684,708,827,666,2889,2941,0.4955,0.5045,1425,861,1366
10,Marzahn–Hellersdorf,2,4,16,Böhlener Straße,5642,447,619,163,655,1875,686,738,459,2719,2923,0.4819,0.5181,1084,782,1229
10,Marzahn–Hellersdorf,2,5,17,Adele-Sandrock-Straße,9124,555,718,147,677,2370,1320,1774,1563,4706,4418,0.5158,0.4842,840,865,1420
10,Marzahn–Hellersdorf,2,5,18,Schleipfuhl,5307,475,582,167,501,1519,708,795,560,2701,2606,0.509,0.491,719,749,1224
10,Marzahn–Hellersdorf,2,5,19,Boulevard Kastanienallee,6076,574,817,207,546,1928,626,771,607,2943,3133,0.4844,0.5156,1231,1024,1598
10,Marzahn–Hellersdorf,2,6,20,Kaulsdorf Nord II,3349,217,203,49,269,1066,420,629,496,1689,1660,0.5043,0.4957,269,252,469
10,Marzahn–Hellersdorf,2,6,21,Gelbes Viertel,6310,648,642,156,622,2018,700,906,618,3188,3122,0.5052,0.4948,807,798,1446
10,Marzahn–Hellersdorf,2,6,22,Kaulsdorf Nord I,8572,433,590,153,486,2261,839,1463,2347,4569,4003,0.533,0.467,536,743,1176
10,Marzahn–Hellersdorf,2,6,23,Rotes Viertel,6523,328,454,109,378,1369,810,1459,1616,3431,3092,0.526,0.474,359,563,891
10,Marzahn–Hellersdorf,3,7,24,Oberfeldstraße,7836,295,489,125,813,1520,1031,1416,2147,3975,3861,0.5073,0.4927,898,614,909
10,Marzahn–Hellersdorf,3,7,25,Buckower Ring,6487,356,457,155,556,1632,792,1075,1464,3215,3272,0.4956,0.5044,788,612,968
10,Marzahn–Hellersdorf,3,7,26,Alt-Biesdorf,3553,225,321,82,205,866,482,535,837,1825,1728,0.5137,0.4863,401,403,628
10,Marzahn–Hellersdorf,3,7,27,Biesdorf Süd,9847,559,867,226,481,1958,1586,1918,2252,4967,4880,0.5044,0.4956,392,1093,1652
10,Marzahn–Hellersdorf,4,8,28,Kaulsdorf Nord,7779,398,643,195,470,1630,1246,1670,1527,3925,3854,0.5046,0.4954,331,838,1236
10,Marzahn–Hellersdorf,4,8,29,Alt-Kaulsdorf,3960,234,285,102,327,854,627,648,883,1967,1993,0.4967,0.5033,267,387,621
10,Marzahn–Hellersdorf,4,8,30,Kaulsdorf Süd,7627,352,666,172,375,1431,1257,1521,1853,3833,3794,0.5026,0.4974,181,838,1190
10,Marzahn–Hellersdorf,4,9,31,Mahlsdorf Nord,9697,537,798,198,503,1987,1572,2012,2090,4865,4832,0.5017,0.4983,317,996,1533
10,Marzahn–Hellersdorf,4,9,32,Alt-Mahlsdorf,4288,259,307,108,286,959,604,814,951,2147,2141,0.5007,0.4993,208,415,674
10,Marzahn–Hellersdorf,4,9,33,Mahlsdorf Süd,15251,830,1277,384,800,2881,2615,3039,3425,7639,7612,0.5009,0.4991,438,1661,2491
11,Lichtenberg,1,1,1,Dorf Malchow,639,40,36,24,59,165,96,125,94,239,400,0.374,0.626,52,60,100
11,Lichtenberg,1,1,2,Dorf Wartenberg,2624,106,239,66,118,513,446,651,485,1300,1324,0.4954,0.5046,73,305,411
11,Lichtenberg,1,1,3,Dorf Falkenberg,1588,111,154,58,112,393,264,322,174,737,851,0.4641,0.5359,305,212,323
11,Lichtenberg,1,2,4,Falkenberg Ost,8934,718,943,248,746,2444,1129,1493,1213,4577,4357,0.5123,0.4877,1637,1191,1909
11,Lichtenberg,1,2,5,Falkenberg West,7020,483,737,203,508,1959,865,1246,1019,3497,3523,0.4981,0.5019,1362,940,1423
11,Lichtenberg,1,2,6,Wartenberg Süd,6109,408,538,165,489,1461,686,1224,1138,3193,2916,0.5227,0.4773,1002,703,1111
11,Lichtenberg,1,2,7,Wartenberg Nord,7501,648,690,212,683,2091,805,1175,1197,3902,3599,0.5202,0.4798,1316,902,1550
11,Lichtenberg,1,3,8,Zingster Straße Ost,11762,768,1047,258,858,2789,1188,2416,2438,6002,5760,0.5103,0.4897,1951,1305,2073
11,Lichtenberg,1,3,9,Zingster Straße West,9717,658,956,258,846,2505,1218,1657,1619,4801,4916,0.4941,0.5059,1627,1214,1872
11,Lichtenberg,1,3,10,Mühlengrund,5736,324,413,111,428,1459,492,1146,1363,2864,2872,0.4993,0.5007,735,524,848
11,Lichtenberg,2,4,11,Malchower Weg,9464,795,915,247,801,2327,1203,1427,1749,4714,4750,0.4981,0.5019,1886,1162,1957
11,Lichtenberg,2,4,12,Hauptstraße,6823,405,567,153,580,1766,752,924,1676,3473,3350,0.509,0.491,912,720,1125
11,Lichtenberg,2,5,13,Orankesee,3978,291,475,134,230,911,539,539,859,2052,1926,0.5158,0.4842,630,609,900
11,Lichtenberg,2,5,14,Große-Leege-Straße,9637,734,700,220,868,3305,1304,1074,1432,4856,4781,0.5039,0.4961,1800,920,1654
11,Lichtenberg,2,5,15,Landsberger Allee,14752,923,1187,348,1289,3751,1787,1756,3711,7626,7126,0.5169,0.4831,2339,1535,2458
11,Lichtenberg,2,5,16,Weiße Taube,4074,307,262,98,238,1194,518,663,794,2068,2006,0.5076,0.4924,340,360,667
11,Lichtenberg,3,6,17,Hohenschönhausener Straße,6327,343,444,112,672,1738,630,577,1811,3189,3138,0.504,0.496,1448,556,899
11,Lichtenberg,3,6,18,Fennpfuhl West,16313,803,929,284,1736,4455,1719,1808,4579,8315,7998,0.5097,0.4903,2727,1213,2016
11,Lichtenberg,3,6,19,Fennpfuhl Ost,11050,689,789,219,1047,3186,1244,1164,2712,5615,5435,0.5081,0.4919,2118,1008,1697
11,Lichtenberg,3,7,20,Herzbergstraße,6187,314,252,66,1330,2385,677,574,589,2528,3659,0.4086,0.5914,3225,318,632
11,Lichtenberg,3,7,21,Rüdigerstraße,24862,1726,1682,443,2468,9592,2910,2486,3555,12289,12573,0.4943,0.5057,4419,2125,3851
11,Lichtenberg,3,8,24,Frankfurter Allee Süd,10063,560,699,207,1254,2857,1110,1150,2226,5052,5011,0.502,0.498,2248,906,1466
11,Lichtenberg,4,9,25,Victoriastadt,4183,405,379,121,347,1947,608,261,115,1991,2192,0.476,0.524,637,500,905
11,Lichtenberg,4,9,26,Weitlingstraße,29331,1986,1837,436,2884,12103,3156,2835,4094,14535,14796,0.4956,0.5044,4448,2273,4259
11,Lichtenberg,4,10,22,Rosenfelder Ring,5488,236,281,85,689,1764,545,562,1326,2588,2900,0.4716,0.5284,1364,366,602
11,Lichtenberg,4,10,23,Gensinger Straße,6748,508,574,132,707,2169,635,692,1331,3428,3320,0.508,0.492,1358,706,1214
11,Lichtenberg,4,10,27,Tierpark,3099,194,206,55,338,883,288,376,759,1548,1551,0.4995,0.5005,574,261,455
11,Lichtenberg,4,11,28,Sewanstraße,25716,1355,1461,445,2481,6374,2587,2939,8074,13544,12172,0.5267,0.4733,3787,1906,3261
11,Lichtenberg,5,12,29,Rummelsburg,4174,449,494,94,279,1466,587,357,448,2097,2077,0.5024,0.4976,501,588,1037
11,Lichtenberg,5,13,30,Karlshorst West,9909,857,755,142,1198,3396,1204,1045,1312,4937,4972,0.4982,0.5018,1366,897,1754
11,Lichtenberg,5,13,31,Karlshorst Nord,10604,757,977,264,644,2806,1589,1432,2135,5569,5035,0.5252,0.4748,667,1241,1998
11,Lichtenberg,5,13,32,Karlshorst Süd,7040,554,944,200,421,1975,1175,821,950,3586,3454,0.5094,0.4906,469,1144,1698
12,Reinickendorf,10,31,15,Breitkopfbecken,7714,425,508,156,956,2156,1061,1017,1435,3876,3838,0.5025,0.4975,1871,664,1089
12,Reinickendorf,10,31,16,Hausotterplatz,9987,687,878,289,1209,2925,1378,1175,1446,4893,5094,0.4899,0.5101,2908,1167,1854
12,Reinickendorf,10,31,17,Letteplatz,10916,781,872,256,1381,3347,1390,1321,1568,5324,5592,0.4877,0.5123,3529,1128,1909
12,Reinickendorf,10,32,18,Teichstraße,13910,894,978,338,1694,3689,1847,1803,2667,7000,6910,0.5032,0.4968,3413,1316,2210
12,Reinickendorf,10,32,19,Schäfersee,8829,505,592,187,1015,2405,1065,1107,1953,4542,4287,0.5144,0.4856,2173,779,1284
12,Reinickendorf,10,32,20,Humboldtstraße,4643,244,253,58,452,1188,687,704,1057,2362,2281,0.5087,0.4913,733,311,555
12,Reinickendorf,21,41,25,Waldidyll/Flughafensee,7760,422,585,162,734,1928,1191,1091,1647,3477,4283,0.4481,0.5519,1370,747,1169
12,Reinickendorf,21,41,26,Tegel Süd,8117,492,618,224,803,1950,1113,1100,1817,4208,3909,0.5184,0.4816,1649,842,1334
12,Reinickendorf,21,44,21,Reinickes Hof,2754,165,181,55,243,767,418,399,526,1374,1380,0.4989,0.5011,635,236,401
12,Reinickendorf,21,44,22,Klixstraße,8229,620,838,264,1037,2138,1070,925,1337,4106,4123,0.499,0.501,2770,1102,1722
12,Reinickendorf,21,44,23,Mellerbogen,5609,296,350,128,546,1289,723,784,1493,2876,2733,0.5127,0.4873,1187,478,774
12,Reinickendorf,21,44,24,Scharnweberstraße,10856,692,896,262,1260,3091,1484,1399,1772,5265,5591,0.485,0.515,3438,1158,1850
12,Reinickendorf,21,45,27,Alt-Tegel,10938,528,535,184,891,2477,1468,1463,3392,5888,5050,0.5383,0.4617,1421,719,1247
12,Reinickendorf,21,45,28,Tegeler Forst,240,10,3,19,83,66,18,19,22,104,136,0.4333,0.5667,67,22,32
12,Reinickendorf,22,42,29,Konradshöhe/Tegelort,6029,281,487,187,403,887,908,1018,1858,3102,2927,0.5145,0.4855,324,674,955
12,Reinickendorf,22,42,30,Heiligensee,18085,948,1474,519,1242,2898,2800,3071,5133,9203,8882,0.5089,0.4911,976,1993,2941
12,Reinickendorf,23,11,1,Hermsdorf,16598,826,1337,464,1203,2571,2479,2596,5122,8634,7964,0.5202,0.4798,1128,1801,2627
12,Reinickendorf,23,11,2,Frohnau,16757,829,1548,545,1132,2389,2563,2532,5219,8699,8058,0.5191,0.4809,908,2093,2922
12,Reinickendorf,30,12,3,Wittenau Süd,14800,731,904,310,1423,3317,2070,2068,3977,7290,7510,0.4926,0.5074,2588,1214,1945
12,Reinickendorf,30,12,4,Wittenau Nord,6216,286,445,192,571,1030,948,1042,1702,3208,3008,0.5161,0.4839,644,637,923
12,Reinickendorf,30,12,5,Waidmannslust,4982,265,402,142,403,989,764,711,1306,2574,2408,0.5167,0.4833,415,544,809
12,Reinickendorf,30,12,6,Lübars,5174,263,481,158,369,886,817,858,1342,2630,2544,0.5083,0.4917,303,639,902
12,Reinickendorf,30,21,7,Schorfheidestraße,3082,155,216,97,336,591,415,421,851,1567,1515,0.5084,0.4916,561,313,468
12,Reinickendorf,30,21,8,Märkisches Zentrum,14888,1120,1658,572,1530,3112,1775,1617,3504,7783,7105,0.5228,0.4772,3282,2230,3350
12,Reinickendorf,30,21,9,Treuenbrietzener Straße,11713,973,1496,426,1171,2840,1337,1205,2265,5997,5716,0.512,0.488,3012,1922,2895
12,Reinickendorf,30,21,10,Dannenwalder Weg,10575,846,1467,441,1198,2459,1292,1081,1791,5427,5148,0.5132,0.4868,3065,1908,2754
12,Reinickendorf,30,22,11,Lübarser Straße,3313,126,170,57,299,586,462,540,1073,1675,1638,0.5056,0.4944,420,227,353
12,Reinickendorf,30,22,12,Rollbergesiedlung,5976,539,791,226,658,1308,772,626,1056,3011,2965,0.5038,0.4962,1813,1017,1556
12,Reinickendorf,30,43,13,Borsigwalde,6803,343,408,150,701,1776,1015,997,1413,3366,3437,0.4948,0.5052,1123,558,901
12,Reinickendorf,30,43,14,Ziekowstraße/Freie Scholle,9732,449,560,208,834,1999,1412,1451,2819,5207,4525,0.535,0.465,714,768,1217